########
#.    .#
#  #   #
#  oo# #
#   p  #
#      #
#      #
########
